01110000000000001110000
01111000000000001110000
01111000000000001110000
01111100000000001110000
01110000000000001110000
01111000000000001110000
01111000000000001110000
01111100000000001110000
01110000000000001110000
01111000000000001110000
01111000000000001110000
01111100000000001110000
00000000000000000000000