0111000000000000111000000
0111100000000000111000000
0111100000000000111011111
0111110000000000111011111
0111000000000000111011111
0111100000000000111011111
0111100000000000111011111
0111110000000000111011111
0111000000000000111011111
0111100000000000111011111
0111100000000000111011111
0111110000000000111011111
0000000000000000000011111