0000020000000000111000000
0111120000000000111000000
0111120000000000111000000
0111120000000222111000000
0111020000000002111000000
0111122222000002111000000
0111100002000000111000000
0111110002000000111000000
0111000022000000111000000
0111100020000000111000000
0112222220000000111000000
0112110000000000112222222
0002000000000000002000000
0000000000000000222000000
0000000000000000200000000
0000000000000000000000000
0000000000000000020000000
0000000022222220020000000
0000000000000022220000000
0000000000011111110000000