0111000000000000111000000
0111100000000000111000000
0111100000000000111000000
0111110000000000111000000
0111000000000000111000000
0111100000000000111000000
0111100000000000111000000
0111110000000000111000000
0111000000000000111000000
0111100000000000111000000
0111100000000000111000000
0111110000000000111000000
0000000000000000000000000
0000000000000000000000000
0000000000000000000000000
0000000000000000000000000
0000000000000000000000000
0000000000000000000000000
0000000000000000000000000
0000000000000000000000000