1111111111111111111111111
2222221111111111111111111
0100021111111111111111111
0001022222111111111111111
0100000002111111122222222
0001000002111111111120001
0000000222111111111120001
1000100211111111111220002
1111000000011111110000002
1111111111111111111000012
2222222111111122222222212
2222111110000002000000002
0002111111100002200000022
1111122222200000000000020
0000000222111111111120000
1000100211111111111220000
0001022222111111111111111
0100000002111111122222211
1111111111111111111111100
2222221111111111111111110