01110000000000001110
01111000000000001110
01111000000000001110
01111100000000001110
01110000000000001110
01111000000000001110
01111000000000001110
01111100000000001110
01110000000000001110
01111000000000001110
01111000000000001110
01111100000000001110
00000000000000000000